11111111111
1E0P0100011
1C000100111
100C0100111
100C0100111
1C000100111
11111111111